100
30
147,0,0,0,147,147,147,147,147,147,147,147,147,147,147,147,147,147,147,147,147,147,147,147,147,147,147,147,147,147,147,147,147,147,147,147,147,147,147,147,147,147,147,147,147,147,147,147,147,147,147,147,147,147,147,147,147,147,147,147,147,147,147,147,147,147,147,147,147,147,147,147,149,147,147,147,147,147,147,147,147,147,147,147,147,147,147,147,147,147,0,0,147,147,147,147,147,147,147,147,
147,0,0,0,147,147,147,147,147,147,147,147,147,147,147,168,0,0,0,0,0,0,0,0,0,0,0,0,0,0,0,0,0,199,0,185,147,147,147,147,147,147,147,147,147,147,147,147,147,147,147,147,147,147,147,147,147,147,147,148,147,147,147,147,147,147,147,147,147,147,147,147,147,147,147,147,147,147,147,147,147,147,147,147,147,147,147,147,147,147,0,0,147,147,147,147,147,147,147,147,
147,0,0,0,147,147,147,147,147,147,147,147,147,147,147,167,0,0,0,0,0,0,0,0,0,0,0,0,0,0,0,0,0,0,0,186,147,147,147,147,147,147,147,147,147,147,147,147,147,147,147,147,147,147,147,147,147,147,147,147,147,147,147,147,147,147,147,147,147,147,147,147,147,147,147,147,147,147,147,147,147,147,147,147,148,147,147,147,147,147,0,0,147,147,147,147,147,147,147,147,
147,0,0,0,147,147,147,147,147,147,147,147,147,147,147,168,0,0,0,0,0,0,0,0,163,164,165,163,164,165,200,0,0,0,0,185,147,147,147,147,147,147,147,147,147,147,147,147,147,147,147,147,147,147,147,147,147,147,147,147,147,147,147,147,147,147,147,147,147,147,147,147,147,147,147,147,147,147,147,147,147,147,147,147,147,147,147,147,147,147,0,0,147,147,147,147,147,147,147,147,
147,0,0,0,147,147,148,147,147,147,147,147,147,147,147,167,0,0,0,0,0,0,0,185,145,147,147,147,147,147,147,0,0,147,147,147,147,147,147,147,148,147,147,147,147,149,147,147,147,147,147,147,147,147,147,147,147,147,147,147,147,147,147,147,147,147,147,147,147,147,147,147,147,147,147,147,147,147,147,147,147,147,147,147,147,147,147,147,147,147,0,0,147,147,147,147,147,147,147,147,
147,0,0,0,147,147,147,147,147,147,147,147,147,147,147,168,0,0,0,0,0,0,0,186,147,147,147,147,147,147,147,0,0,147,147,147,147,147,147,147,147,147,147,147,147,147,147,147,148,147,147,147,147,147,147,147,147,147,147,147,147,147,147,147,147,149,147,147,147,147,147,147,147,148,147,147,147,147,147,147,147,147,147,147,147,147,147,147,147,147,0,0,147,147,147,147,147,147,147,147,
147,0,0,0,147,147,147,147,147,147,147,147,147,147,147,147,147,202,0,0,0,0,0,185,147,147,147,147,147,147,147,0,0,147,149,147,147,147,147,147,147,147,147,147,147,147,147,147,147,147,147,147,147,147,147,147,147,147,147,147,147,147,147,147,147,147,147,147,147,147,147,147,147,147,147,147,147,147,147,147,147,147,147,147,147,147,147,147,147,147,0,0,147,147,147,147,147,147,147,147,
147,0,0,0,147,147,147,147,147,147,147,147,147,147,147,147,202,182,0,0,0,0,0,186,147,147,147,147,148,147,147,0,0,147,147,147,147,147,147,147,147,147,147,147,147,147,147,147,147,147,147,147,147,147,147,147,148,147,147,147,147,147,147,147,147,147,147,147,147,147,147,147,147,147,147,147,147,147,147,147,147,147,147,147,147,147,147,147,147,147,0,0,147,147,147,147,147,147,147,147,
147,0,0,0,147,147,147,147,147,147,147,147,147,147,147,168,0,0,0,0,0,0,217,218,147,147,147,147,147,147,147,0,0,147,147,147,147,147,147,147,147,147,147,148,147,147,147,147,147,147,147,147,147,147,147,147,147,147,147,147,147,147,147,147,147,147,147,147,147,147,147,147,147,147,147,147,147,147,181,182,183,181,182,183,181,182,183,181,182,183,0,0,147,147,147,147,147,147,147,147,
147,0,0,0,147,147,147,147,147,147,147,147,147,147,147,167,0,0,0,0,0,0,0,0,147,147,147,147,147,147,147,0,0,147,147,147,147,147,147,147,147,147,147,147,147,147,147,147,147,147,147,147,147,147,147,147,147,147,147,147,147,147,147,147,147,147,147,147,147,147,147,147,147,147,147,147,147,202,0,0,0,0,0,0,0,0,0,0,0,0,0,0,147,147,148,147,147,147,147,147,
147,0,0,0,147,147,147,147,147,147,147,147,147,148,147,220,219,221,0,0,0,0,0,0,147,147,147,147,147,147,147,0,0,147,147,147,147,147,147,147,147,147,147,147,147,147,147,147,147,147,147,147,147,147,147,147,147,147,147,147,147,181,182,183,181,182,183,181,182,183,181,182,183,181,182,183,181,0,0,0,0,0,0,0,0,0,0,0,0,0,0,0,147,147,147,147,147,147,147,147,
147,0,0,0,147,147,147,147,148,147,147,147,147,147,147,167,0,0,0,0,0,0,0,0,147,147,147,147,147,147,147,0,0,147,147,147,147,147,147,147,202,168,0,0,0,0,0,0,0,185,201,147,147,147,147,147,147,147,147,147,147,0,0,0,0,0,0,0,0,0,0,0,0,0,0,0,0,0,0,0,0,0,0,0,0,0,0,163,0,0,0,0,147,147,147,147,147,147,147,147,
147,0,0,0,147,147,147,147,147,147,147,147,147,147,147,168,0,0,0,0,163,164,165,163,147,147,147,147,147,147,147,0,0,147,147,147,147,202,168,0,0,0,0,0,0,0,0,0,0,0,186,201,147,147,147,147,147,147,147,147,147,0,0,0,0,0,0,0,0,0,0,0,0,0,0,0,0,145,146,220,221,0,0,0,0,217,218,146,166,0,0,0,147,147,147,147,147,147,147,147,
147,0,0,0,147,147,147,147,147,147,147,147,147,147,147,167,0,0,0,185,145,147,147,147,147,147,147,147,147,147,147,0,0,147,147,147,147,167,0,0,0,0,0,0,0,0,0,0,0,0,0,185,147,147,147,147,147,147,147,147,147,0,0,0,0,0,0,0,0,0,0,0,0,0,0,0,0,147,147,0,0,0,0,0,0,0,0,147,167,0,0,0,147,147,147,147,147,147,149,147,
147,0,0,0,147,147,147,147,147,147,147,147,147,147,147,168,0,0,217,218,201,147,147,147,147,147,147,147,147,149,147,0,0,147,147,147,147,168,0,0,96,0,0,0,0,0,0,0,0,0,0,186,201,147,147,147,147,147,147,147,147,0,0,0,0,0,0,0,0,0,0,0,0,0,0,0,0,147,147,163,164,165,163,164,165,163,164,147,168,0,0,0,147,147,147,147,147,147,147,147,
147,0,0,0,147,147,147,147,147,147,147,149,147,147,147,167,0,0,0,0,182,183,147,147,147,147,147,147,147,147,147,0,0,147,147,147,147,167,0,0,0,0,0,0,0,0,0,0,0,0,0,0,0,185,147,147,147,147,147,147,147,163,164,165,163,164,165,163,164,165,163,164,165,163,164,165,163,147,147,147,147,147,147,147,147,147,147,147,166,0,0,0,147,147,147,147,147,147,147,147,
147,0,0,0,147,148,147,147,147,147,147,147,147,147,148,220,221,0,0,163,164,165,147,147,147,147,147,147,147,147,147,0,0,147,147,147,147,168,0,0,0,0,0,0,0,0,0,0,0,0,0,0,0,186,147,147,147,147,147,147,0,0,0,147,147,147,147,147,147,147,147,147,147,147,147,147,147,147,147,147,147,147,147,147,147,147,147,147,167,0,0,0,147,147,147,147,147,147,147,147,
147,0,0,0,147,147,147,147,147,147,147,147,147,147,202,167,0,0,0,145,147,147,147,147,147,147,147,147,147,147,147,0,0,147,147,147,147,167,0,0,0,0,0,0,0,0,0,0,0,0,0,0,0,185,147,147,147,147,147,0,0,0,147,147,147,147,147,147,147,147,147,147,147,147,147,147,149,147,147,147,147,148,147,147,147,147,147,147,168,0,0,0,147,147,147,147,147,147,147,147,
147,167,0,0,0,0,0,0,0,0,0,0,0,0,0,0,0,0,163,147,147,147,147,148,147,147,147,147,147,147,147,0,0,147,147,147,202,168,0,0,0,0,0,0,0,0,0,0,0,0,0,0,0,186,147,147,147,147,0,0,0,147,147,147,147,147,147,147,147,182,183,147,147,147,147,147,147,147,147,147,147,147,147,147,147,147,147,147,166,0,0,0,147,147,147,147,147,147,147,147,
147,168,0,0,0,0,0,0,0,0,0,0,0,0,0,0,164,165,145,147,147,147,147,147,147,147,147,147,147,147,147,181,0,0,0,0,0,0,0,0,0,0,0,0,0,0,0,0,0,0,0,0,0,185,147,147,147,0,0,0,147,147,147,147,147,147,147,147,0,0,0,181,182,183,147,147,147,147,147,147,147,147,147,147,147,147,147,202,167,0,0,0,147,147,147,147,147,147,148,147,
147,167,0,0,0,0,0,0,0,0,200,0,0,0,0,184,145,147,147,147,147,147,147,147,147,147,147,147,147,147,147,0,0,0,0,0,0,0,0,0,0,0,0,0,0,0,0,0,0,0,0,0,0,0,0,0,0,0,0,147,147,147,147,147,147,147,147,147,0,501,0,0,0,0,0,0,0,0,181,182,183,181,182,183,181,182,183,181,0,0,0,0,147,147,147,147,147,147,147,147,
147,168,0,0,0,0,0,0,0,185,145,147,147,147,147,147,147,147,147,147,147,147,147,147,147,147,147,147,147,147,147,163,164,165,163,164,165,163,164,165,163,164,165,163,164,165,163,164,165,163,164,165,163,164,165,163,163,163,147,147,147,147,147,147,147,147,147,147,163,0,0,0,0,0,181,0,0,0,163,164,165,163,164,165,163,164,165,163,164,165,0,0,147,147,147,147,147,147,147,147,
147,147,147,147,147,147,147,147,147,147,147,147,147,147,147,147,147,147,147,147,147,147,147,147,147,147,147,147,147,147,147,147,147,147,147,147,147,147,147,147,147,147,147,147,147,147,147,147,147,147,147,147,147,147,147,147,147,147,147,147,147,147,147,149,147,147,147,147,147,164,165,0,0,0,163,147,147,147,147,147,147,147,147,147,147,147,147,147,147,147,147,147,147,147,147,147,147,147,147,147,
147,148,147,147,147,147,147,147,147,147,147,147,147,149,147,147,147,147,147,147,147,147,147,147,147,147,147,147,147,147,147,147,147,147,147,147,147,147,147,147,147,147,147,147,147,147,147,147,147,147,147,147,147,147,147,147,147,147,147,147,147,147,147,147,147,147,147,147,147,147,147,163,164,165,147,147,147,147,147,147,147,147,147,147,147,147,147,147,147,147,147,147,147,147,147,147,147,147,147,147,
147,147,147,147,147,147,148,147,147,147,147,147,147,147,147,147,147,147,147,147,147,147,147,147,147,147,147,147,147,147,147,147,147,148,147,147,147,147,147,147,147,147,147,147,147,148,147,147,147,147,147,147,147,147,147,147,147,147,147,147,147,147,147,147,147,147,147,147,147,147,147,147,147,147,147,147,147,147,147,147,147,147,147,147,147,147,147,147,147,147,147,147,147,147,147,147,147,147,147,147,
147,147,147,147,147,147,147,147,147,147,147,147,147,147,147,147,147,147,148,147,147,147,147,147,147,147,147,147,147,147,147,147,147,147,147,147,147,147,147,147,147,147,147,147,147,147,147,147,147,147,147,147,147,147,147,147,147,147,147,147,147,147,147,147,147,147,147,147,147,147,147,147,147,147,147,147,147,147,147,147,147,147,147,147,147,147,147,147,147,147,147,147,147,147,147,147,147,147,147,147,
147,147,147,147,147,147,147,147,147,147,147,147,147,147,147,147,147,147,147,147,147,147,147,147,147,147,147,147,147,147,147,147,147,147,147,147,147,147,149,147,147,147,147,147,147,147,147,147,147,147,147,147,147,147,147,147,147,147,148,147,147,147,147,147,147,147,147,147,147,147,147,147,147,147,147,147,147,147,147,147,147,147,147,147,147,147,147,148,147,147,147,147,147,147,147,147,147,147,147,147,
147,147,149,147,147,147,147,147,147,147,148,147,147,147,147,147,147,147,147,147,147,147,147,147,147,147,149,147,147,147,147,147,147,147,147,147,147,147,147,147,147,147,147,147,147,147,147,147,147,147,147,147,147,147,147,147,147,147,147,147,147,147,147,147,147,147,147,147,147,147,147,147,147,147,147,147,147,147,147,149,147,147,147,147,147,147,147,147,147,147,147,147,147,147,147,147,147,147,147,147,
147,147,147,147,147,147,147,147,147,147,147,147,147,147,147,147,147,147,147,147,147,147,147,147,147,147,147,147,147,147,147,147,147,147,147,147,147,147,147,147,147,147,147,147,147,147,147,147,147,147,147,147,147,147,147,147,147,147,147,147,147,147,147,147,147,147,147,147,147,148,147,147,147,147,147,147,147,147,147,147,147,147,147,147,147,147,147,147,147,147,147,147,147,147,147,147,147,147,147,147,
147,147,147,148,147,147,147,147,147,147,147,147,147,147,147,147,147,147,147,147,147,147,147,147,147,147,147,147,147,147,147,147,147,147,147,147,147,147,147,147,147,147,147,147,148,147,147,147,147,147,147,147,147,147,147,147,147,147,147,147,147,147,147,147,147,147,147,147,147,147,147,147,147,147,147,147,147,147,147,147,147,147,147,147,147,147,147,147,147,147,147,147,147,147,147,147,147,147,147,147